BAMBI	Euarchontoglires
CDK1	Eukaryota
ANGPT1	Bilateria
SLC26A3	cellular organisms
LY96	Boreoeutheria
ITGB2	Bilateria
SPRY1	Bilateria
ETS1	Bilateria
CYR61	Amniota
MMRN1	Bilateria
NAMPT	Euarchontoglires
PHB	Eukaryota
TSHR	Bilateria
GDF15	Bilateria
PADI3	Euarchontoglires
MYB	Eukaryota
PCSK6	cellular organisms
MKNK2	Eukaryota
TLR9	Eukaryota
EMX2	Bilateria
HDAC5	cellular organisms
GJD2	Euteleostomi
BTAF1	cellular organisms
XRCC1	Eukaryota
GPR39	Bilateria
EZH2	Eukaryota
ADAMTS5	Bilateria
HIP1	Eukaryota
GATA5	Opisthokonta
HEY2	Bilateria
CXCL10	Euteleostomi
OTC	cellular organisms
GP1BA	Eukaryota
DNAJB4	cellular organisms
ACP5	Eukaryota
UGT1A4	cellular organisms
CD40	Amniota
SIGIRR	Bilateria
ATF6	Eukaryota
GTF2A1	Eukaryota
RASGEF1B	Eukaryota
KDM4B	Eukaryota
PDGFRA	Eukaryota
SLC19A2	Eukaryota
THRSP	Euteleostomi
GAPDH	cellular organisms
SYK	Eukaryota
LIPE	cellular organisms
BTRC	Eukaryota
HLA-E	Amniota
SOCS1	Amniota
TSC2	Eukaryota
HBZ	Euteleostomi
HOXC10	Eukaryota
TBR1	Bilateria
EGLN2	Eukaryota
PDHA1	cellular organisms
SFTPD	Bilateria
UHRF1	Eukaryota
LHCGR	Bilateria
BHLHE22	Bilateria
ULK1	Eukaryota
PIAS1	Eukaryota
ZBTB17	Euteleostomi
NCOA3	Bilateria
NPHS2	cellular organisms
ADAMTS1	Bilateria
MAT2A	cellular organisms
SNAI3	Opisthokonta
BIRC2	Eukaryota
HOXA4	Eukaryota
ARNT2	Opisthokonta
FKBP4	cellular organisms
DNASE2	Bilateria
MCM6	cellular organisms
CCND2	Eukaryota
S100A7	Boreoeutheria
PDE6A	Eukaryota
KHSRP	Eukaryota
NR2F6	Bilateria
FTO	Euarchontoglires
PDCD11	cellular organisms
DEFA1	Euarchontoglires
MMP12	Eukaryota
HOXC13	Bilateria
DEFB103A	Euarchontoglires
LAMC2	Bilateria
HLA-DPA1	Euteleostomi
SP2	Opisthokonta
HOXD3	Bilateria
CTCF	Bilateria
TMPRSS2	Bilateria
IGF1	Euteleostomi
NTRK1	Eukaryota
LTC4S	Boreoeutheria
FAM57A	Euarchontoglires
WAS	Opisthokonta
TAL1	Bilateria
UBE2S	Eukaryota
ZNF268	Euteleostomi
MMACHC	Bilateria
MS4A1	Boreoeutheria
PRTN3	Bilateria
GNRH2	Euteleostomi
IL7	Boreoeutheria
CYP2A6	cellular organisms
TINF2	Euarchontoglires
CCND1	Eukaryota
F12	Bilateria
SDHB	cellular organisms
WEE1	Eukaryota
TNFAIP3	Bilateria
BLMH	Opisthokonta
ST3GAL3	Eukaryota
NRAS	Eukaryota
ADORA2A	Bilateria
NFRKB	Tetrapoda
SPHK1	cellular organisms
STAT1	Eukaryota
SCD	Eukaryota
HSD17B1	cellular organisms
FGFR3	Eukaryota
WDR5	Eukaryota
CD58	Homo
MAD2L1	Eukaryota
SETDB1	Eukaryota
BUB1B	Eukaryota
LMO3	Opisthokonta
PA2G4	cellular organisms
ZEB2	Bilateria
TIMP1	Bilateria
POLE2	Eukaryota
IL17C	Boreoeutheria
SCN9A	Opisthokonta
FOXF1	Opisthokonta
NR4A2	Bilateria
EGLN3	Eukaryota
DKK3	Amniota
LRP8	Bilateria
VLDLR	Bilateria
FMO4	cellular organisms
CTNNBIP1	Euteleostomi
NELFCD	Bilateria
IFNL1	Amniota
NFYC	Eukaryota
NOTCH1	Eukaryota
CYP19A1	cellular organisms
TAC1	Boreoeutheria
KLF16	Opisthokonta
MMP28	Eukaryota
SPI1	Bilateria
CDK6	Eukaryota
ID1	Bilateria
CEBPD	Bilateria
FGF16	Bilateria
SLC13A3	cellular organisms
UGT1A8	cellular organisms
TRIM28	Eukaryota
ZNF750	Euteleostomi
CDC5L	Eukaryota
PHF10	Eukaryota
CHD4	cellular organisms
KDM5C	Eukaryota
PCSK2	cellular organisms
F13A1	Amniota
PPARA	Bilateria
HOXB13	Eukaryota
KRT7	Bilateria
APLF	Bilateria
MEF2D	Eukaryota
ITGA2B	Bilateria
ZHX2	Euarchontoglires
ITGA5	Bilateria
GC	Amniota
HFE	Amniota
IKBKB	cellular organisms
TYRP1	Bilateria
CHRNA5	cellular organisms
ZNF350	Boreoeutheria
TRERF1	Bilateria
HR	Eukaryota
FABP4	Bilateria
ATP6V0A2	cellular organisms
CD6	Bilateria
HMGA1	Euarchontoglires
TBX4	Bilateria
SOX1	Eukaryota
CDC34	Eukaryota
SLC20A1	cellular organisms
CABIN1	Eukaryota
RPTOR	Eukaryota
HDAC11	cellular organisms
ELK4	Bilateria
GFAP	Bilateria
OAT	cellular organisms
RHOA	Eukaryota
PCBD1	cellular organisms
HES6	Bilateria
FCGR1A	Bilateria
CDKN1C	Euarchontoglires
HDAC9	cellular organisms
HIC1	Bilateria
ITGAM	Bilateria
WASF3	Eukaryota
GHR	Amniota
VGF	Boreoeutheria
TDRD1	Eukaryota
ADM	Boreoeutheria
ATF3	Bilateria
PTPN13	Eukaryota
CYP1A1	cellular organisms
CD19	Euarchontoglires
BACH2	Bilateria
ICAM1	Boreoeutheria
KPNB1	Eukaryota
MFN2	Eukaryota
CFH	Bilateria
NOL7	Euarchontoglires
CYP1B1	cellular organisms
ASAP2	Eukaryota
NELL2	Eukaryota
NDUFV2	cellular organisms
CYP46A1	cellular organisms
NKX6-1	Eukaryota
L3MBTL1	Bilateria
ZNF239	Euteleostomi
WT1	Opisthokonta
GIPR	Bilateria
TERF2	Eukaryota
NKX2-1	Eukaryota
FGF8	Bilateria
CREB3L1	Eukaryota
NQO1	cellular organisms
TGFBR3	Euteleostomi
ZNF274	Boreoeutheria
PROS1	Eukaryota
KRT5	Bilateria
CETP	Eukaryota
CD44	Boreoeutheria
DCDC2	Eukaryota
L1CAM	Bilateria
CDCA7L	Eukaryota
CCNG2	Eukaryota
PURA	Eukaryota
IGF1R	Eukaryota
NOTCH4	Eukaryota
PREB	Eukaryota
BIRC7	Eukaryota
SLC6A4	cellular organisms
CDKL5	Eukaryota
GTF2B	cellular organisms
INSM1	Bilateria
ELL	Bilateria
HDAC10	cellular organisms
GAD1	cellular organisms
TCF7	Opisthokonta
MFSD2A	cellular organisms
GMPS	cellular organisms
CCNA2	Eukaryota
FSTL3	Euteleostomi
XBP1	Bilateria
HSPD1	cellular organisms
KRT17	Bilateria
FOXA2	Opisthokonta
TGFBI	Eukaryota
VIM	Bilateria
LGR5	Eukaryota
ELF4	Bilateria
IL18	Amniota
CHST4	Euteleostomi
DEFA6	Euarchontoglires
CYP11A1	cellular organisms
POLR1A	cellular organisms
CD59	Euarchontoglires
CD79A	Boreoeutheria
DLL4	Eukaryota
FOSB	Amniota
EDN1	Boreoeutheria
PTGES	Boreoeutheria
C1QBP	Opisthokonta
CYP3A4	cellular organisms
TXNRD1	cellular organisms
MIA	Amniota
NME1	cellular organisms
DCC	Bilateria
NPAS2	Bilateria
AMACR	cellular organisms
NOX1	Eukaryota
POMGNT1	Eukaryota
CCL21	Boreoeutheria
NFE2L1	Bilateria
CSF1	Euarchontoglires
SIM2	Bilateria
FMN2	Eukaryota
IKZF1	Opisthokonta
POU2AF1	Boreoeutheria
GRHL2	Bilateria
CDX1	Bilateria
PSMD6	Eukaryota
IAPP	Amniota
CBFB	Bilateria
UGT1A9	cellular organisms
FZD1	Bilateria
BATF3	Euteleostomi
CREB3L4	Eukaryota
HSPA1B	cellular organisms
SLC2A3	cellular organisms
CERS2	Eukaryota
CD8B	Euarchontoglires
ECM1	Euarchontoglires
TPH1	cellular organisms
ACVRL1	Eukaryota
CTNNB1	Eukaryota
TDO2	cellular organisms
PCNA	cellular organisms
ZNRD1	cellular organisms
RBM38	Eukaryota
ANTXR1	Euarchontoglires
MZF1	Euteleostomi
REEP5	Eukaryota
SOX2	Eukaryota
TDG	cellular organisms
PCSK9	cellular organisms
RFX3	Opisthokonta
PTGDS	Amniota
ACADL	cellular organisms
SLC16A1	Opisthokonta
UPF1	cellular organisms
PER1	Bilateria
TRPS1	Opisthokonta
FSHB	Amniota
PSMB9	cellular organisms
MYH11	Eukaryota
COL4A4	Bilateria
TRIM25	Eukaryota
CA9	Eukaryota
HBD	Euteleostomi
TWIST1	Bilateria
CHGB	Boreoeutheria
MATN1	Bilateria
HIST2H4A	Eukaryota
TYMS	cellular organisms
ILK	Eukaryota
IL4	Boreoeutheria
HSD17B6	cellular organisms
ACHE	cellular organisms
PRC1	Eukaryota
KLF6	Opisthokonta
SOX18	Eukaryota
PTGER4	Bilateria
ECE1	Bilateria
CSF2RA	Amniota
FCGR3B	Boreoeutheria
CXCL14	Euarchontoglires
FDFT1	Eukaryota
MTA1	Bilateria
FOXO3	Opisthokonta
EPHA3	Eukaryota
SHBG	Boreoeutheria
MUC3A	Boreoeutheria
MYC	Opisthokonta
SPIC	Bilateria
SLC22A4	cellular organisms
AMH	Bilateria
HOXB1	Bilateria
CHEK2	Eukaryota
GJB1	Euteleostomi
GPX4	cellular organisms
GTF3A	Eukaryota
CDKN3	Eukaryota
ADAM17	Opisthokonta
FGF21	Bilateria
CD22	Bilateria
PCLAF	Tetrapoda
HBP1	Eukaryota
RFC3	cellular organisms
IRF2BP2	Euteleostomi
MT2A	Boreoeutheria
LPAR2	Bilateria
RAB4B	Eukaryota
SMURF2	Eukaryota
MX1	Eukaryota
C4A	cellular organisms
GSC	Eukaryota
ABCG4	cellular organisms
E2F5	Eukaryota
KDR	Eukaryota
WNT11	Bilateria
CYP2B6	cellular organisms
KCTD11	Eukaryota
ESCO2	Eukaryota
NR4A1	Bilateria
WWP1	Eukaryota
CALD1	Amniota
CYP2C19	cellular organisms
ARHGEF1	Eukaryota
ATAD2	cellular organisms
SCARB2	Eukaryota
ADIPOR1	Eukaryota
MAP3K5	Eukaryota
PDGFRB	Eukaryota
PKM	cellular organisms
ENO1	cellular organisms
DNASE2B	Bilateria
PAX8	Bilateria
MNDA	Euarchontoglires
LIN28A	cellular organisms
PDIA6	cellular organisms
LEFTY1	Bilateria
ADAM10	Opisthokonta
MCM5	cellular organisms
COL11A2	Bilateria
TMEM71	Euteleostomi
APCS	Boreoeutheria
GABPB1	cellular organisms
CIC	Eukaryota
SUGP1	Eukaryota
CXADR	Euteleostomi
MEF2C	Eukaryota
MYF6	Bilateria
DPYSL2	cellular organisms
PRKCB	Eukaryota
LPIN1	Eukaryota
KISS1	Euarchontoglires
GBA	Opisthokonta
CSF1R	Eukaryota
POLD1	cellular organisms
ARID3A	Eukaryota
BATF	Euteleostomi
FCGRT	Amniota
STMN2	Amniota
MMP17	Eukaryota
PHB2	Eukaryota
SEPT7	Opisthokonta
RECQL4	cellular organisms
DSG4	Bilateria
PPL	Euarchontoglires
WFS1	Bilateria
MUC1	Opisthokonta
RBMX	Eukaryota
NCF2	Eukaryota
ITGAV	Eukaryota
POU1F1	Eukaryota
EPAS1	Bilateria
TEF	Bilateria
ZNF148	Bilateria
ATF5	Euteleostomi
CRYGC	Euteleostomi
PDE7A	Eukaryota
NR2C2	Bilateria
NFKBIA	Eukaryota
HIVEP2	Opisthokonta
HLX	Eukaryota
CIITA	Boreoeutheria
MXD1	Bilateria
MEF2A	Eukaryota
MCM7	cellular organisms
CD40LG	Amniota
ARNTL	Eukaryota
XRCC6	Eukaryota
YY1	Eukaryota
KRT16	Bilateria
DMD	Eukaryota
FABP6	Bilateria
VAMP2	Eukaryota
TOMM34	Eukaryota
APOD	cellular organisms
CDC25A	Eukaryota
CLK3	Eukaryota
SPIB	Bilateria
CTBP1	cellular organisms
MSH6	cellular organisms
OCLN	Tetrapoda
TOP1	Eukaryota
LTBP4	Eukaryota
ABCG5	cellular organisms
CCR3	Bilateria
SPRR3	Euarchontoglires
JDP2	Bilateria
HSD11B2	cellular organisms
SLBP	Bilateria
NKX2-3	Bilateria
GLIS3	Opisthokonta
PPM1D	Eukaryota
ATP6V0E1	Bilateria
MMP9	Eukaryota
IBSP	Amniota
DRD1	Bilateria
TP73	Euteleostomi
HINFP	Opisthokonta
GATA2	Opisthokonta
ERCC2	cellular organisms
ETV5	Bilateria
KLK4	Bilateria
CLOCK	Bilateria
APAF1	Eukaryota
CCL22	Amniota
GTF3C2	Bilateria
APOA1	Euteleostomi
PLRG1	Eukaryota
BAG2	Boreoeutheria
FOXC1	Opisthokonta
NTS	Boreoeutheria
CD8A	Amniota
PRMT1	cellular organisms
EVPL	Euarchontoglires
ABCG2	cellular organisms
MYBBP1A	Opisthokonta
LRIG2	Opisthokonta
ZBTB14	Bilateria
CCND3	Eukaryota
TCERG1	Eukaryota
CLDN7	Euteleostomi
KLF13	Opisthokonta
G0S2	Euarchontoglires
DMRT1	Bilateria
TFF3	Boreoeutheria
GPX1	cellular organisms
HOXA7	Eukaryota
RFX5	Opisthokonta
MAPK8	cellular organisms
DEDD	Euarchontoglires
GUCY2C	Eukaryota
ZNF382	Amniota
DBF4	Opisthokonta
TFCP2L1	Bilateria
LRRFIP1	Tetrapoda
PPARD	Bilateria
C3	Amniota
MCAT	cellular organisms
NAB2	Bilateria
CD24	Homininae
MTA3	Bilateria
UTF1	Euarchontoglires
CRABP2	Bilateria
PLAG1	Bilateria
RUNX3	Bilateria
KHDRBS1	Eukaryota
CD36	Eukaryota
PTGIR	Boreoeutheria
SRY	Eukaryota
NR1H2	Bilateria
RRM1	cellular organisms
KL	cellular organisms
MGMT	cellular organisms
LTB	Boreoeutheria
SCD5	Eukaryota
TNFSF13B	Euarchontoglires
ST6GAL1	Eukaryota
DMAP1	Eukaryota
TCF12	Bilateria
IPO13	Eukaryota
TP63	Euteleostomi
COMP	Eukaryota
FOXA1	Opisthokonta
ADORA3	Bilateria
CTPS1	cellular organisms
GZF1	Euteleostomi
CDC25C	Eukaryota
HMGXB4	Eukaryota
ABCB11	cellular organisms
UBTF	Eukaryota
PHOX2B	Eukaryota
CHAC1	cellular organisms
ID3	Bilateria
WHSC1	Eukaryota
TRH	Euteleostomi
ZBTB7A	Bilateria
IFNA2	Amniota
APLNR	Bilateria
FHL2	Eukaryota
ALAS1	cellular organisms
BMP7	Bilateria
CYP2J2	cellular organisms
ZNF217	Bilateria
MLXIPL	Bilateria
RUVBL1	cellular organisms
IL2RG	Amniota
TAF1B	Euteleostomi
SLPI	Euarchontoglires
ATP5F1A	cellular organisms
SP7	Opisthokonta
IFNA1	Amniota
SUPT3H	Eukaryota
TLX2	Bilateria
KLF5	Opisthokonta
TOP2B	cellular organisms
ADA	cellular organisms
CENPW	Amniota
FPGS	cellular organisms
SLC22A2	cellular organisms
SOX7	Eukaryota
FABP2	Bilateria
PROX1	Bilateria
AGER	Euteleostomi
EGFR	Eukaryota
SRPX	Bilateria
FGA	Amniota
CCR7	Bilateria
MYEF2	Eukaryota
CDH17	Bilateria
SMAD6	Bilateria
METAP2	cellular organisms
TFF2	Boreoeutheria
FGF19	Bilateria
PTHLH	Euteleostomi
ETV6	Bilateria
NELFB	Bilateria
LOX	Euteleostomi
BBC3	Euarchontoglires
GJA1	Euteleostomi
MSLN	Euarchontoglires
CDA	cellular organisms
ABCG8	cellular organisms
GLCE	cellular organisms
PIR	cellular organisms
BTG2	Eukaryota
GINS3	Eukaryota
ALOX15B	cellular organisms
MTDH	Euarchontoglires
NEDD4L	Eukaryota
HOXC11	Eukaryota
ZFP36	Eukaryota
HAND2	Bilateria
LIF	Boreoeutheria
MDM2	Eukaryota
MT1F	Boreoeutheria
DCN	Eukaryota
HOXA1	Bilateria
INS	Euteleostomi
ITGA6	Eukaryota
TOP2A	cellular organisms
ALDH1A3	cellular organisms
PEG10	Boreoeutheria
E2F1	Eukaryota
IGFBP5	Bilateria
HAMP	Euteleostomi
NOX5	Eukaryota
SLC9A1	cellular organisms
CTCFL	Bilateria
TBL1X	Eukaryota
RARA	Bilateria
ITGA9	Eukaryota
SULT2A1	Eukaryota
PPP2R2D	Eukaryota
HEPH	Eukaryota
VEGFD	Euteleostomi
ITGB1	Bilateria
TBX20	Bilateria
MICB	Amniota
TCEAL1	Boreoeutheria
FOXL2	Opisthokonta
GABPA	Bilateria
CPT1A	Opisthokonta
MSMB	Euarchontoglires
GALNT3	Bilateria
RPLP0	cellular organisms
MYL9	Eukaryota
IL10	Amniota
IGFBP4	Euteleostomi
BAD	Euarchontoglires
TGFB1	Bilateria
BRD2	Eukaryota
ERCC1	Eukaryota
RARB	Bilateria
PTGS2	Eukaryota
TRIM22	Eukaryota
ZNF383	Euteleostomi
GSTM1	Eukaryota
PRSS50	Bilateria
SATB2	Bilateria
ZNF160	Euteleostomi
RELA	Bilateria
BSG	Bilateria
KLF10	Opisthokonta
FUT7	Eukaryota
PIAS2	Eukaryota
ASAH1	Bilateria
TERF1	Eukaryota
LCAT	Eukaryota
CBX5	Eukaryota
MAFB	Euteleostomi
PF4	Amniota
CLU	Boreoeutheria
DRAP1	Eukaryota
CALB1	Eukaryota
HIF3A	Bilateria
SYN1	Bilateria
ISL1	Eukaryota
LIN28B	cellular organisms
CCL13	Amniota
RARG	Bilateria
SLC22A6	cellular organisms
CRHR1	Bilateria
HSP90AA1	cellular organisms
TNFRSF13C	Euarchontoglires
BMI1	Eukaryota
CCL2	Amniota
NCOA6	Euarchontoglires
RREB1	Opisthokonta
TSC22D1	Bilateria
SOX9	Eukaryota
VWF	Bilateria
CCL11	Amniota
ETV1	Bilateria
OLR1	Eukaryota
RFX2	Opisthokonta
HEYL	Eukaryota
RXFP2	Eukaryota
GRPR	Bilateria
FGFR1	Eukaryota
AGGF1	Eukaryota
ARID1B	Eukaryota
CDK2	Eukaryota
ASCL1	Bilateria
NFKB1	Eukaryota
SIX1	Eukaryota
MMP7	Eukaryota
KLF17	Bilateria
STK11	Eukaryota
U2AF2	Eukaryota
SPAST	cellular organisms
HPGD	cellular organisms
LILRB4	Boreoeutheria
TDGF1	Amniota
NCOA2	Bilateria
RDX	Eukaryota
MAPK3	Eukaryota
NR1I3	Bilateria
UGT2B4	cellular organisms
PTPRC	Eukaryota
CXCR4	Bilateria
SLC26A4	Eukaryota
NES	Euteleostomi
NPHS1	Bilateria
IFNB1	Amniota
LHX4	Eukaryota
FGF9	Bilateria
ILF3	Bilateria
TRIB2	Eukaryota
SLC39A1	Eukaryota
EIF3M	Eukaryota
MCL1	Amniota
FBP1	cellular organisms
CDAN1	Bilateria
ARNTL2	Eukaryota
ZNF202	Amniota
ITGB8	Bilateria
ACR	Bilateria
DYRK1A	Eukaryota
ADH5	cellular organisms
DLX4	Bilateria
TP53BP1	Opisthokonta
RETN	Boreoeutheria
HSD3B2	cellular organisms
AKR1C2	cellular organisms
RPL3	cellular organisms
CDCA7	Boreoeutheria
PSIP1	Eukaryota
UGDH	cellular organisms
SMARCA1	cellular organisms
NFIX	Bilateria
MYBL2	Eukaryota
ZMYND11	Bilateria
CBX7	Eukaryota
TALDO1	cellular organisms
SLC9A3	Eukaryota
CFLAR	Bilateria
ASXL1	Bilateria
SSTR1	Bilateria
IL1R1	Bilateria
MYOG	Bilateria
IL23A	Euarchontoglires
FOS	Bilateria
SLC25A20	Eukaryota
ADAM12	Opisthokonta
BDNF	Euteleostomi
GLI2	Eukaryota
BRD4	Eukaryota
KIT	Eukaryota
ACLY	cellular organisms
CEACAM5	Bilateria
BCL11A	Opisthokonta
BCL3	cellular organisms
PGA5	Eukaryota
FASLG	Amniota
ABCC2	cellular organisms
CYP3A7	cellular organisms
IGFBP1	Euteleostomi
RLN2	Euarchontoglires
COL18A1	Boreoeutheria
GSK3B	Eukaryota
MECOM	Bilateria
TRPM1	Eumetazoa
CRISP1	Eukaryota
PCYT1A	cellular organisms
KCNQ2	cellular organisms
G6PC	Euteleostomi
SLC39A3	Eukaryota
E2F6	Eukaryota
COPS5	Eukaryota
TEAD4	Opisthokonta
SLC22A10	cellular organisms
PER3	Bilateria
FGFBP1	Boreoeutheria
RUNX1	Bilateria
FOXN4	Opisthokonta
ATXN7	Opisthokonta
PSMC5	cellular organisms
DDX5	cellular organisms
NR2F1	Bilateria
HBG1	Euteleostomi
MVP	Eukaryota
NEDD4	Eukaryota
HLA-A	Amniota
ERP44	cellular organisms
KPNA1	Eukaryota
COL4A2	Opisthokonta
ACTG2	Eukaryota
HNF1A	Bilateria
SHOX	Eukaryota
RUNX1T1	Bilateria
APEX1	cellular organisms
EDA	Bilateria
ATP2A3	cellular organisms
PPBP	Euteleostomi
VEGFC	Euteleostomi
PAX1	Bilateria
EXO1	Eukaryota
TFPT	Boreoeutheria
TAF7	Eukaryota
MMP10	Eukaryota
BGLAP	Tetrapoda
ERAP1	cellular organisms
SOX17	Eukaryota
FGL1	Bilateria
MPL	Euarchontoglires
CTSL	Eukaryota
MEP1A	Eumetazoa
AKR1B1	cellular organisms
IL5	Boreoeutheria
NMNAT2	Eukaryota
EHF	Bilateria
HLA-DOA	Euteleostomi
SLC2A4	cellular organisms
BNIP3	Bilateria
FUS	Eukaryota
MAPKAPK3	Eukaryota
MUC4	Eukaryota
HIPK2	Eukaryota
CHUK	cellular organisms
TGFB2	Bilateria
LOXL4	Bilateria
GH2	Euteleostomi
SFTPA1	Euteleostomi
ZNF410	Opisthokonta
WIF1	Eukaryota
ING1	Eukaryota
HTATIP2	cellular organisms
CBFA2T3	Amniota
CYP7A1	cellular organisms
SDC1	Bilateria
FXR2	Bilateria
NTRK3	Eukaryota
ELF3	Bilateria
FABP1	Bilateria
BABAM2	Chordata
PDK4	cellular organisms
WNT7B	Bilateria
NR1D1	Bilateria
FGFR4	Eukaryota
PER2	Bilateria
PTEN	Eukaryota
TXNIP	Opisthokonta
POU2F3	Bilateria
TLE1	Eukaryota
THBS2	Bilateria
SHMT1	cellular organisms
KLK10	Bilateria
RFX1	Opisthokonta
MCPH1	Eukaryota
NR0B2	Bilateria
RXRA	Bilateria
LGALS4	Eukaryota
HEXIM1	Euteleostomi
MAFK	Euteleostomi
VEGFA	Euteleostomi
BECN1	Eukaryota
PLOD1	Eukaryota
CKS2	Eukaryota
PRKCQ	Eukaryota
IL5RA	Euarchontoglires
KLF11	Opisthokonta
DENND4A	Eukaryota
CYBB	Eukaryota
DHFR	cellular organisms
DEFB1	Amniota
MCTS1	cellular organisms
DES	Bilateria
PLAGL1	Bilateria
ZNF175	Euteleostomi
KLF1	Opisthokonta
CHRNB4	Bilateria
ZNF300	Euteleostomi
PBXIP1	Amniota
CASP9	Bilateria
PDLIM7	Eukaryota
KRT13	Bilateria
SPART	Eukaryota
KCNN2	Bilateria
APOB	Bilateria
CRMP1	cellular organisms
CXCL5	Euteleostomi
KPNA2	Eukaryota
SSPN	Euarchontoglires
PPP1R13B	cellular organisms
SIGMAR1	Eukaryota
KCNIP3	Eukaryota
SLC6A3	cellular organisms
CARM1	Eukaryota
EFNB3	Euteleostomi
FUT3	Eukaryota
UTRN	Eukaryota
RNF2	Eukaryota
PGR	Bilateria
NFIA	Bilateria
SNAI1	Opisthokonta
IL12A	Boreoeutheria
MUC6	Amniota
PSMD3	Eukaryota
URI1	Eukaryota
GADD45A	Opisthokonta
BRCA2	Eukaryota
ELAVL1	Eukaryota
GATA6	Opisthokonta
SOX5	Eukaryota
KLRK1	Amniota
CX3CL1	Boreoeutheria
UGT2B7	cellular organisms
RAP1A	Eukaryota
HSP90AB1	cellular organisms
RCAN1	Bilateria
EREG	Euarchontoglires
IGF2BP1	Eukaryota
MGAT5	Bilateria
MEIS2	Eukaryota
DDIT3	Boreoeutheria
INPP5J	Eukaryota
ADRB2	Bilateria
COX6A1	Eukaryota
SERTAD1	Euarchontoglires
PDCD4	Eukaryota
IL21	Boreoeutheria
CYSLTR1	Bilateria
RAD51B	cellular organisms
PDE6B	Eukaryota
HLA-DRB4	Euteleostomi
BAX	Euteleostomi
SCAI	Eukaryota
GNRH1	Amniota
HOXC9	Eukaryota
PITX2	Eukaryota
ASPM	Eukaryota
CCL4	Amniota
PSG3	Bilateria
NLRC4	Tetrapoda
IL32	Homo
POU3F4	Opisthokonta
GSTP1	Eukaryota
NOTCH3	cellular organisms
NR3C2	Bilateria
TLR6	Eukaryota
TRAF1	Euteleostomi
JAK1	Eukaryota
GZMB	Bilateria
CASP8	Bilateria
JAK2	Eukaryota
GP1BB	Euarchontoglires
CXCL12	Tetrapoda
MYL7	Eukaryota
RFWD2	Eukaryota
SNCB	Boreoeutheria
CYP2C9	cellular organisms
BHMT	cellular organisms
PRSS8	Bilateria
UXT	Eukaryota
FDXR	cellular organisms
PDHX	cellular organisms
CIP2A	Amniota
GBX2	Bilateria
PCK1	cellular organisms
S100A11	Amniota
WNT2	Bilateria
PMAIP1	Euarchontoglires
ATM	Eukaryota
BIRC3	Eukaryota
CREM	Bilateria
DNMT1	cellular organisms
WISP2	Amniota
PGLYRP2	Bilateria
BCL2	Euteleostomi
OGG1	Eukaryota
COL4A1	Bilateria
HOXB7	Bilateria
DDX18	cellular organisms
RAD51	cellular organisms
IFNAR1	Amniota
GFI1B	Bilateria
PDGFB	Boreoeutheria
ENG	Euteleostomi
HLA-DRB3	Euteleostomi
HOXD13	Opisthokonta
SLC15A1	cellular organisms
PNRC1	Boreoeutheria
FES	Eukaryota
ZAP70	Eukaryota
GPA33	Bilateria
ERG	Bilateria
RECK	Euteleostomi
PFKFB4	cellular organisms
KCNH2	cellular organisms
LITAF	Eukaryota
SLC4A2	Eukaryota
TBP	cellular organisms
IRF4	Amniota
MEAF6	Opisthokonta
GCGR	Bilateria
PGK1	cellular organisms
DDX58	cellular organisms
SYN2	Bilateria
PIP5K1C	Eukaryota
NFKBIB	Eukaryota
JUN	Opisthokonta
NANOG	Eukaryota
BCL6	Bilateria
TCF7L2	Opisthokonta
AURKA	Eukaryota
LCN2	Amniota
SQSTM1	Opisthokonta
HCFC1	Eukaryota
GJA5	Euteleostomi
EGF	Eukaryota
LOXL2	Bilateria
HOXD1	Bilateria
PRKN	Eukaryota
LILRB1	Boreoeutheria
SUZ12	Eukaryota
LIN54	Eukaryota
PLA2G2A	Boreoeutheria
SKIL	Bilateria
SOX3	Eukaryota
GLI1	Eukaryota
BID	Amniota
LEF1	Opisthokonta
RNF14	Eukaryota
LIPC	Bilateria
PTK6	Eukaryota
TLR4	Eukaryota
EBNA1BP2	Eukaryota
HMOX1	Opisthokonta
GRK2	Eukaryota
CD4	Euarchontoglires
CFI	Bilateria
NUCB1	Boreoeutheria
ORMDL3	Opisthokonta
EDEM2	Eukaryota
ITGB3	Bilateria
HRAS	Eukaryota
SMN1	Bilateria
CXXC5	Bilateria
FOXO1	Opisthokonta
TNFSF4	Euarchontoglires
MCAM	Bilateria
ERAP2	cellular organisms
GP9	Bilateria
MEF2B	Eukaryota
CHD8	cellular organisms
NFIL3	Bilateria
XPA	Opisthokonta
PTGDR2	Bilateria
RAD9A	Opisthokonta
POU3F1	Opisthokonta
PTAFR	Bilateria
SPRR1A	Euarchontoglires
SURF2	Euarchontoglires
PTPN6	Eukaryota
PSG5	Bilateria
NLRP2	Eukaryota
MAOA	Eukaryota
ABL1	Eukaryota
CFB	Bilateria
ERBB3	Eukaryota
MKL1	Euarchontoglires
TP53BP2	cellular organisms
PMEL	Amniota
ZNF205	Boreoeutheria
PCSK1	cellular organisms
CASP3	Bilateria
HLA-DQB2	Euteleostomi
LEP	Amniota
NFKBIZ	Eukaryota
HLA-DMB	Euteleostomi
HPGDS	Eukaryota
RND3	Eukaryota
PKLR	cellular organisms
PLAU	Bilateria
AATF	Eukaryota
FAM162A	Bilateria
KAT2B	Eukaryota
NOD1	Eukaryota
TOB1	Eukaryota
CD70	Euarchontoglires
CCNE2	Eukaryota
HDAC4	cellular organisms
CTSS	Eukaryota
ALDH1A1	cellular organisms
ICAM2	Boreoeutheria
SERPINE1	cellular organisms
CASP1	Bilateria
DNMT3A	Eukaryota
PDE5A	Eukaryota
TNFRSF11A	Amniota
NPAS3	Bilateria
SPAG6	Eukaryota
GM2A	Euarchontoglires
IL3	Homininae
PTGS1	Eukaryota
CD34	Euarchontoglires
ESRRB	Bilateria
DNAJC12	cellular organisms
ESRRG	Bilateria
CKM	cellular organisms
ABCA1	cellular organisms
ACBD3	Euteleostomi
JUND	Eukaryota
DUSP6	Eukaryota
HLA-DQA2	Euteleostomi
ATP2C1	cellular organisms
CSH2	Euteleostomi
MEFV	Euteleostomi
SLC34A2	Boreoeutheria
SELL	Bilateria
WWC1	Opisthokonta
INO80	cellular organisms
MTHFR	cellular organisms
EPB41L3	Eukaryota
FAT1	Bilateria
CD80	Bilateria
BCAS2	Eukaryota
MDC1	Opisthokonta
MUC5AC	Amniota
FOXN1	Opisthokonta
TFEB	Eukaryota
KMT2A	Eukaryota
PHGDH	cellular organisms
ESR2	Bilateria
BIN1	Opisthokonta
NOD2	Eukaryota
IL1RN	Boreoeutheria
MED23	Eukaryota
HLA-DRB1	Euteleostomi
RELB	Bilateria
NRIP1	Euarchontoglires
SMARCD3	Eukaryota
COX7C	Boreoeutheria
FGB	Bilateria
GCSAM	Euarchontoglires
IL1R2	Bilateria
SLC10A2	cellular organisms
RAG1	Opisthokonta
ETV2	Bilateria
APOE	Euteleostomi
RASGRP1	Eukaryota
OCA2	cellular organisms
MCM3	cellular organisms
LYZ	Bilateria
GNAS	Eukaryota
APOC3	Boreoeutheria
DAPK2	Eukaryota
PLG	Bilateria
GBP1	Opisthokonta
TP53I3	cellular organisms
DRD2	Bilateria
FUBP1	Eukaryota
CISH	Eukaryota
A2M	cellular organisms
NCOA4	Homo
ISG20	cellular organisms
NAB1	Bilateria
MTF2	Eukaryota
ERP29	Eukaryota
RIPK2	Eukaryota
MAPK1	Eukaryota
SPRY2	Bilateria
MCM10	Opisthokonta
UBE2C	Eukaryota
CLCN5	cellular organisms
MLYCD	Euarchontoglires
GKN2	Boreoeutheria
TBX5	Bilateria
CR2	Bilateria
AKR1C4	cellular organisms
IL6R	Amniota
BCL2L13	Euarchontoglires
E2F7	Eukaryota
CEBPB	Bilateria
GUCY1B1	Eukaryota
ADRA2B	Bilateria
TERT	Eukaryota
USP7	Eukaryota
CYP24A1	cellular organisms
PON1	Bilateria
CCL5	Amniota
HSF2	Eukaryota
RACGAP1	Eukaryota
DNASE1	Amniota
BCAR1	Eukaryota
PLIN2	Bilateria
SUMO2	Eukaryota
HTR1A	Bilateria
SSX2	Euarchontoglires
CRYAB	Bilateria
RTN3	Eukaryota
TFAP2B	Bilateria
ECT2	Eukaryota
ASNS	cellular organisms
PNOC	Boreoeutheria
SKP2	Eukaryota
PLK4	Eukaryota
TBXT	Bilateria
UBE2I	Eukaryota
GGPS1	cellular organisms
COL10A1	Euteleostomi
ERCC5	cellular organisms
CAPNS1	Eukaryota
PCYT2	cellular organisms
HYOU1	cellular organisms
HLA-DQA1	Euteleostomi
DST	Eukaryota
FOXJ1	Opisthokonta
ABL2	Eukaryota
MC2R	Bilateria
SOCS3	Amniota
FBN1	Eukaryota
HSPA4	cellular organisms
SET	Eukaryota
HESX1	Eukaryota
SIVA1	Euarchontoglires
IDO2	Opisthokonta
POLR3D	Opisthokonta
HAX1	Boreoeutheria
CCR1	Bilateria
IKBKE	cellular organisms
PLB1	Theria
DMPK	Eukaryota
TNFRSF12A	Euarchontoglires
FOXA3	Opisthokonta
DAPK1	Eukaryota
MYCN	Bilateria
BDKRB2	Bilateria
PTTG1IP	Euarchontoglires
RB1	Eukaryota
TRIM16	Euteleostomi
PEBP1	Eukaryota
HBEGF	Amniota
CCNB2	Eukaryota
PRODH	Eukaryota
ALOX5	cellular organisms
SALL3	Opisthokonta
MEIS1	Eukaryota
PLAUR	Boreoeutheria
TOPBP1	Eukaryota
L1TD1	Euarchontoglires
THBD	Bilateria
DICER1	cellular organisms
FLT3	Eukaryota
KMT5A	Eukaryota
GPNMB	Amniota
MXI1	Bilateria
IVL	Euarchontoglires
CR1	Bilateria
PLXNA1	Bilateria
HTRA2	cellular organisms
FIGLA	Bilateria
ADAM23	Opisthokonta
RBL1	Eukaryota
VSX2	Eukaryota
LRP5	Bilateria
FOXP1	Opisthokonta
LIMD1	Eukaryota
PBX2	Eukaryota
BAG1	Euarchontoglires
EPB41L4B	Eukaryota
CNOT7	Eukaryota
EP300	Eukaryota
GDNF	Euteleostomi
EIF2AK2	cellular organisms
HIRA	Eukaryota
SAMD4A	Opisthokonta
FCER2	Bilateria
COX1	Eukaryota
STS	cellular organisms
RNASEL	cellular organisms
HHEX	Eukaryota
PSMD11	Eukaryota
TFCP2	Bilateria
MGP	Amniota
ALK	Eukaryota
CCNB1	Eukaryota
IDE	cellular organisms
SMPD1	Eukaryota
GDAP1	Eukaryota
DACH1	Bilateria
IL6	Amniota
NEFL	Bilateria
NFE2	Bilateria
CCAR2	Eukaryota
HNRNPA2B1	Eukaryota
PRKAB1	Eukaryota
APOA4	Euteleostomi
PRDM14	Opisthokonta
IFNL2	Amniota
FBXO32	Boreoeutheria
ACOT7	cellular organisms
MPZ	Tetrapoda
CYP17A1	cellular organisms
DLX5	Bilateria
TLE3	Eukaryota
WDFY4	Eukaryota
CDC6	cellular organisms
TSG101	Eukaryota
APOA2	Boreoeutheria
SHOX2	Eukaryota
ZNF335	Bilateria
VEGFB	Euteleostomi
CNTNAP2	Eukaryota
EDNRB	Bilateria
CCR5	Bilateria
ONECUT1	Bilateria
ITGAX	Bilateria
ADIPOQ	Bilateria
SLC2A4RG	Euteleostomi
STARD4	Euteleostomi
VEZF1	Bilateria
MAZ	Bilateria
STARD7	Boreoeutheria
S100B	Amniota
EGR2	Opisthokonta
ERBB2	Eukaryota
LATS2	Eukaryota
DLG1	cellular organisms
MSR1	Bilateria
SOX6	Eukaryota
NFYB	Eukaryota
C4BPB	Bilateria
FN1	Bilateria
PIK3R3	Eukaryota
CD82	Bilateria
FGF1	Bilateria
GLI3	Eukaryota
HERC2	Eukaryota
ATF7	Eukaryota
AGR2	Euteleostomi
TRAF6	Eukaryota
CTSB	Eukaryota
ACE2	Bilateria
BST2	Euarchontoglires
CYLD	Boreoeutheria
AURKB	Eukaryota
PLK3	Eukaryota
NAIP	Opisthokonta
PODXL	Amniota
GREB1	Euteleostomi
ABCB1	cellular organisms
ARF6	Eukaryota
RAD51AP1	Amniota
SLC13A4	cellular organisms
NONO	Eukaryota
IL15	Boreoeutheria
HEMGN	Boreoeutheria
SFRP1	Bilateria
BLK	Eukaryota
BEST1	Bilateria
SETBP1	Euarchontoglires
SERPINC1	cellular organisms
FLT4	Eukaryota
F7	Bilateria
PRDX3	cellular organisms
TMEM158	Boreoeutheria
NR1H3	Bilateria
SRCAP	cellular organisms
SLC19A1	Bilateria
VCAM1	Bilateria
GRIN2B	Eukaryota
BPI	Eukaryota
UMOD	Eukaryota
BCAS3	Eukaryota
ACTN4	Eukaryota
RFXANK	cellular organisms
IRF2	Amniota
SERPINB1	cellular organisms
ACACB	cellular organisms
GML	Euarchontoglires
POLD2	Eukaryota
TNPO1	Eukaryota
YWHAQ	Eukaryota
SOD1	cellular organisms
NRXN1	Bilateria
MLANA	Homininae
AXIN2	Bilateria
DLK1	Eukaryota
POU2F1	Bilateria
EYA3	Eukaryota
DKK1	Amniota
REPS2	Eukaryota
CREG1	Amniota
EPSTI1	Euarchontoglires
DEC1	Bilateria
RET	Eukaryota
OAS1	Boreoeutheria
ALOX12	cellular organisms
CHGA	Boreoeutheria
EHMT2	cellular organisms
PSCA	Euarchontoglires
HSD17B11	cellular organisms
TP53INP1	Euarchontoglires
TEK	Eukaryota
PDGFA	Euteleostomi
ZFP36L1	Eukaryota
IGF2BP2	cellular organisms
ARID1A	Eukaryota
MNAT1	Opisthokonta
MAOB	cellular organisms
PSMB10	cellular organisms
ACTA1	Eukaryota
GRHL1	Bilateria
SFTPC	Boreoeutheria
CCL26	Amniota
FXN	Eukaryota
RHOB	Eukaryota
MMP3	Eukaryota
SDC4	Bilateria
TFE3	Eukaryota
HOPX	Euteleostomi
BAG3	Eukaryota
SSTR2	Bilateria
HNF1B	Euteleostomi
USP26	Eukaryota
S100P	Amniota
AQP3	cellular organisms
PPP2CA	Eukaryota
IPO7	Eukaryota
PLK1	Eukaryota
HIF1A	Bilateria
KCNN4	Bilateria
CDK20	Eukaryota
SLCO4C1	Eukaryota
GALT	cellular organisms
FSHR	Bilateria
CLDN2	Euteleostomi
LRRN3	Eukaryota
CAPN6	Eukaryota
E2F4	Eukaryota
B2M	Euteleostomi
GSK3A	Eukaryota
IL2RB	Euarchontoglires
ERO1A	Eukaryota
RORC	Bilateria
MAVS	Euarchontoglires
PRNP	Amniota
TBXA2R	Boreoeutheria
PAX2	Bilateria
ZNF76	Bilateria
NF1	Eukaryota
LCT	cellular organisms
SLC9A2	cellular organisms
NOX4	Eukaryota
TOMM70	cellular organisms
APP	Bilateria
RRM2	cellular organisms
STAT5B	Eukaryota
CFTR	cellular organisms
NCOR2	Eukaryota
SREBF2	Eukaryota
KRT4	Bilateria
ADGRE5	Eukaryota
TYK2	Eukaryota
MMP1	Eukaryota
MYD88	Bilateria
NPPA	Amniota
CCNE1	Eukaryota
CRY2	cellular organisms
C1QTNF5	Euteleostomi
DOCK1	Eukaryota
ESRRA	Bilateria
FOXK2	Eukaryota
SEMG1	Euarchontoglires
HPSE	Eukaryota
DKK4	Amniota
TNFRSF1B	Amniota
TFRC	cellular organisms
PRKCE	Eukaryota
EBF1	Bilateria
CYP11B2	cellular organisms
CD28	Amniota
DNMT3L	Amniota
CGB3	Amniota
CELSR3	Bilateria
CXCR5	Bilateria
NOTUM	Eukaryota
S100A9	Amniota
TBXAS1	cellular organisms
BACE1	Eukaryota
CCR6	Bilateria
PRL	Euteleostomi
IRF6	Amniota
SRC	Eukaryota
HDAC8	cellular organisms
FGF7	Bilateria
SULT1E1	Eukaryota
NODAL	Bilateria
PDIA2	cellular organisms
NKX3-1	Bilateria
WRN	cellular organisms
PLSCR1	Opisthokonta
FASN	cellular organisms
GFI1	Bilateria
FGG	Bilateria
CDC73	Eukaryota
CCNA1	Eukaryota
FCGR2B	Amniota
TPT1	Eukaryota
CYFIP2	Eukaryota
RAG2	Euteleostomi
ETV3	Bilateria
CCL20	Boreoeutheria
MMP14	Eukaryota
FGF10	Bilateria
E2F8	Eukaryota
PPARGC1A	Boreoeutheria
SIX6	Eukaryota
PTTG1	Boreoeutheria
IRF8	Amniota
GCLC	Eukaryota
RELN	Eukaryota
NEIL1	Eukaryota
RNF7	Eukaryota
RNF8	Eukaryota
SLC7A1	cellular organisms
DDC	cellular organisms
E4F1	Euteleostomi
HLA-DOB	Euteleostomi
STIM1	Bilateria
PHOX2A	Eukaryota
PDCD2	Eukaryota
DRG2	cellular organisms
PFKFB3	cellular organisms
YES1	Eukaryota
TLR7	Eukaryota
SIX5	Eukaryota
SLC1A4	cellular organisms
SRSF1	Eukaryota
SIAH1	Eukaryota
DCT	Euteleostomi
GJC2	Euteleostomi
GTF3C1	Euarchontoglires
NR5A2	Bilateria
UBE2D3	Eukaryota
SLC46A1	Bilateria
DIRAS3	Eukaryota
ATP1B1	Bilateria
MYH10	Eukaryota
IL17RB	Euteleostomi
PAX6	Opisthokonta
TAF1	Eukaryota
RSF1	Eukaryota
MEN1	Boreoeutheria
IFIT3	cellular organisms
IRF5	Amniota
SNIP1	Eukaryota
CXCL2	Euteleostomi
MMP13	Eukaryota
POU3F2	Opisthokonta
NEUROD1	Bilateria
HBE1	Euteleostomi
LMO2	Eukaryota
HCK	Eukaryota
PPARG	Bilateria
ETV4	Bilateria
SCNN1A	Bilateria
TFDP3	Eukaryota
BTK	Eukaryota
NHLH2	Bilateria
ILF2	Bilateria
PML	Bilateria
HOXB4	Eukaryota
APH1A	Eukaryota
TIMP2	Bilateria
FOXD1	Opisthokonta
REG4	Eukaryota
TLR10	Eukaryota
SESN1	Eukaryota
LCK	Eukaryota
LTA	Amniota
SERBP1	Amniota
UHRF1BP1	Eukaryota
USF2	Eukaryota
KRT12	Bilateria
SND1	Eukaryota
NDRG2	Eukaryota
GATA4	Eukaryota
SP4	Eukaryota
ZFHX3	Eukaryota
MKI67	Boreoeutheria
SMARCB1	Eukaryota
PROM1	Bilateria
APBB1	Bilateria
TGIF1	Eukaryota
HDGF	Eukaryota
PTGFR	Euteleostomi
HSD3B1	cellular organisms
MAF	Euteleostomi
WFDC2	Boreoeutheria
P2RX4	Boreoeutheria
SATB1	Bilateria
TP53	Euteleostomi
GDF3	Bilateria
PLAA	Eukaryota
UPF2	Eukaryota
CD247	Boreoeutheria
FUBP3	Eukaryota
MPO	Eukaryota
GFER	Eukaryota
FOXE1	Opisthokonta
CXCR2	Bilateria
USF1	Opisthokonta
GUSB	cellular organisms
CARD8	Euarchontoglires
NR0B1	Bilateria
LTF	Euteleostomi
ZEB1	Bilateria
MYBL1	Eukaryota
DUSP4	Eukaryota
ATF4	Euteleostomi
CASP7	Bilateria
FXYD2	Boreoeutheria
RASGRP3	Eukaryota
NR2F2	Bilateria
MAT2B	cellular organisms
ALOX15	cellular organisms
IFNL3	Amniota
FTH1	Eukaryota
SPRR1B	Euarchontoglires
MC1R	Bilateria
CES1	cellular organisms
SLC22A3	cellular organisms
NFIB	Bilateria
TIMP3	Bilateria
LGALS1	Bilateria
DCK	cellular organisms
ROS1	Eukaryota
STAT4	Eukaryota
DUSP10	Eukaryota
MAP3K14	cellular organisms
PITX1	Eukaryota
SESN3	Eukaryota
GCM1	Bilateria
TICAM1	Boreoeutheria
MCM4	cellular organisms
TSC22D3	Bilateria
SH2D1A	Bilateria
CSF3R	Bilateria
TUBB3	Eukaryota
CTSV	Eukaryota
ZBTB16	Euteleostomi
SLC5A1	cellular organisms
SUMO1	Eukaryota
KDM2A	Eukaryota
NKX2-5	Bilateria
TFAM	Eukaryota
CSRP1	Eukaryota
PECAM1	Boreoeutheria
MADCAM1	Euarchontoglires
NPSR1	Bilateria
LXN	Amniota
NKX2-2	Eukaryota
NCAM1	Bilateria
HDAC3	cellular organisms
CYP2E1	cellular organisms
ETS2	Bilateria
SLA2	Bilateria
GSC2	Eukaryota
NCOR1	Eukaryota
ZBTB5	Opisthokonta
HDAC2	cellular organisms
IGF2	Amniota
FOSL1	Euteleostomi
KLF8	Eukaryota
MECP2	Euarchontoglires
PARP1	Eukaryota
BCL2L1	Bilateria
MXD4	Bilateria
TFPI2	Bilateria
TNFSF11	Amniota
FUT2	Bilateria
RBL2	Eukaryota
SPRR2A	Euarchontoglires
TGFA	Boreoeutheria
MDM4	Euteleostomi
ERBB4	Eukaryota
ABCA3	cellular organisms
CDH13	Bilateria
JARID2	Eukaryota
HSPA5	cellular organisms
MAP1LC3A	Eukaryota
RPS3A	cellular organisms
FOXD3	Opisthokonta
CD46	Bilateria
ZNF224	Euteleostomi
UGT2B15	cellular organisms
FMO3	cellular organisms
SRF	Eukaryota
LTBP1	Eukaryota
SERPINB9	cellular organisms
ACKR3	Bilateria
BAK1	Amniota
ZBTB2	Bilateria
CABLES1	Euarchontoglires
NRCAM	Bilateria
CD151	Bilateria
ITGAD	Bilateria
TAF5	Eukaryota
TFAP2C	Bilateria
SCTR	Bilateria
STAT3	Eukaryota
LTBR	Boreoeutheria
CYP7B1	cellular organisms
SNW1	Eukaryota
TLX1	Bilateria
HIST2H2BE	Eukaryota
HMGN1	Amniota
TFDP1	Eukaryota
NR5A1	Bilateria
MUC17	Homo
SRPX2	Bilateria
IL1A	Boreoeutheria
DEFA5	Euarchontoglires
PPP1R3C	Opisthokonta
CD83	Euarchontoglires
PADI1	Euarchontoglires
TAGLN	Eukaryota
FOXQ1	Opisthokonta
NT5E	cellular organisms
AES	Bilateria
FLT1	Eukaryota
NPY	Euteleostomi
IL11	Euarchontoglires
LDLR	Bilateria
NR2E3	Bilateria
TNFRSF9	Boreoeutheria
CDKN1A	Euarchontoglires
SHH	Bilateria
FABP7	Bilateria
ALDH1A2	cellular organisms
NFE2L2	Bilateria
ABCC6	cellular organisms
MCM8	cellular organisms
UGT2B17	cellular organisms
MLL3	Eukaryota
ANG	Euteleostomi
KCNMA1	cellular organisms
UGCG	Eukaryota
TOE1	Eukaryota
ZNF24	Bilateria
TCF19	Bilateria
SERPINB2	cellular organisms
YEATS4	Eukaryota
E2F3	Eukaryota
HOXA9	Eukaryota
CD1D	Amniota
CREB5	Opisthokonta
CD163	Bilateria
DEFA3	Euarchontoglires
PTPRZ1	Eukaryota
HMGA2	Euarchontoglires
STARD3	Bilateria
HOMER3	Eukaryota
SIRT1	cellular organisms
RASSF1	Eukaryota
ELMO3	Eukaryota
MSX1	Bilateria
HSD17B2	cellular organisms
FABP5	Bilateria
SFPQ	Eukaryota
DHRS2	cellular organisms
RUNX2	Bilateria
VCAN	Bilateria
SP100	Opisthokonta
EVX1	Bilateria
E2F2	Eukaryota
SREBF1	Eukaryota
WWTR1	Opisthokonta
ACKR1	Boreoeutheria
TNFSF14	Boreoeutheria
CXCL1	Euteleostomi
CDK5R1	Bilateria
NQO2	cellular organisms
PELP1	Euarchontoglires
OPRM1	Bilateria
TRPV6	Eukaryota
ZNF267	Euteleostomi
IRF7	Amniota
TRIP6	Eukaryota
MMP2	Eukaryota
TRIB3	Eukaryota
ANKRD1	cellular organisms
MAML1	Boreoeutheria
LMO7	Eukaryota
PFDN4	Eukaryota
LDHC	cellular organisms
ACO1	cellular organisms
RHOC	Eukaryota
GP6	Boreoeutheria
PLTP	Eukaryota
NR1I2	Bilateria
CD38	Euarchontoglires
SNRPN	Eukaryota
ELF2	Bilateria
NFATC3	Amniota
CRTC1	Bilateria
CDC42	Eukaryota
CCR2	Bilateria
ABCC1	cellular organisms
DNMT3B	Eukaryota
SRD5A3	Eukaryota
SLC2A1	cellular organisms
AKT1	Eukaryota
RARRES1	Amniota
C4B	cellular organisms
BRD7	Eukaryota
HPSE2	Eukaryota
JUP	Eukaryota
CRH	Boreoeutheria
DNAJC3	cellular organisms
ATOH1	Bilateria
CBX8	Eukaryota
IFNG	Amniota
CXCL8	Euteleostomi
HBB	Euteleostomi
ING4	Eukaryota
EMSY	Eukaryota
SYMPK	Opisthokonta
SNAP91	Eukaryota
UGT1A10	cellular organisms
ADH6	cellular organisms
HLTF	cellular organisms
TJP1	Bilateria
TBX21	Bilateria
GADD45G	Boreoeutheria
LILRB2	Boreoeutheria
SLC25A27	Eukaryota
PDK2	Eukaryota
GNMT	cellular organisms
TNIP3	Euarchontoglires
ISYNA1	Eukaryota
FUT4	Eukaryota
CTSG	Bilateria
MEOX2	Bilateria
LAMB1	Bilateria
HLA-B	Amniota
BRS3	Bilateria
PSEN2	Eukaryota
CRLF1	Amniota
PIGR	Boreoeutheria
CTGF	Amniota
CYP2F1	cellular organisms
MAX	Eukaryota
PTGER2	Boreoeutheria
BRD3	Eukaryota
MYOCD	Boreoeutheria
ERVW-1	Euarchontoglires
MELTF	Euteleostomi
TAF4	Eukaryota
PRAM1	Euarchontoglires
TGFB3	Bilateria
CCNT1	Eukaryota
AKAP12	Euarchontoglires
AGTR1	Bilateria
STIP1	cellular organisms
IFNLR1	Amniota
IRAK2	cellular organisms
PDGFC	Bilateria
EPCAM	Amniota
HOXC6	Eukaryota
HECA	Bilateria
FOXM1	Opisthokonta
TAF12	Eukaryota
SMG6	Eukaryota
PSEN1	Eukaryota
ACTC1	Eukaryota
TNFRSF21	Amniota
DDB2	Eukaryota
IL1B	Boreoeutheria
IGFBP3	Bilateria
NME3	cellular organisms
TNFRSF10B	Boreoeutheria
GABRB3	cellular organisms
ARL6IP5	Amniota
DDR2	Eukaryota
MED15	Bilateria
MTTP	Bilateria
PELO	cellular organisms
FOXO4	Opisthokonta
LGALS3BP	Bilateria
CDKN2A	Eukaryota
PTP4A1	Eukaryota
CRYGA	Euteleostomi
IRF3	Amniota
PHF8	Eukaryota
PBK	cellular organisms
ST3GAL5	Eukaryota
SGK1	Eukaryota
ASCL2	Bilateria
GTF2F1	Bilateria
RCC1	Eukaryota
SAP30	Bilateria
NGF	Euteleostomi
LDHA	cellular organisms
TSC1	Euarchontoglires
CLCNKA	Eukaryota
SIDT1	Bilateria
MTA2	Bilateria
TAPBP	Amniota
CCL7	Tetrapoda
LGALS9	Bilateria
RETNLB	Boreoeutheria
MAD1L1	Eukaryota
BLM	cellular organisms
HDAC1	cellular organisms
KRT18	Bilateria
OGN	Bilateria
POU4F2	Bilateria
FGL2	Bilateria
CRYGB	Euteleostomi
CITED2	Tetrapoda
ITGB4	Bilateria
MYH9	Eukaryota
RGS4	Bilateria
CNMD	Euteleostomi
PLIN1	Bilateria
MRVI1	Euteleostomi
XIAP	Eukaryota
TEAD1	Opisthokonta
ETF1	cellular organisms
FOLH1	Eukaryota
KLK1	Bilateria
EOMES	Bilateria
IER3	Tetrapoda
SIRT2	cellular organisms
FANCA	Bilateria
SLC5A8	cellular organisms
BHLHE40	Bilateria
CACNA1H	Eukaryota
CD74	Bilateria
JCHAIN	Euarchontoglires
NCOA1	Bilateria
XPC	Eukaryota
CYP4F12	cellular organisms
SMYD1	Eukaryota
TNFRSF17	Euarchontoglires
SYP	Boreoeutheria
PIAS3	Eukaryota
SEMA6A	Bilateria
UCP1	Eukaryota
HOXA11	Eukaryota
MS4A2	Euarchontoglires
LNPEP	cellular organisms
HMGCR	cellular organisms
COL11A1	Bilateria
BGN	cellular organisms
UCP2	Eukaryota
DACT1	Euteleostomi
S1PR1	Bilateria
SMARCA4	cellular organisms
XPO1	Eukaryota
CHRNE	Bilateria
SOX14	Eukaryota
WNT5A	Bilateria
ST3GAL1	Eukaryota
OLIG2	Bilateria
MLLT10	Eukaryota
KRT20	Bilateria
PAX5	Bilateria
KLF12	Opisthokonta
ACACA	cellular organisms
EED	Eukaryota
CYP2C8	cellular organisms
LMTK2	Eukaryota
BARD1	cellular organisms
PBX1	Eukaryota
TH	cellular organisms
BHLHE41	Bilateria
WWOX	cellular organisms
HIST1H4L	Eukaryota
SELE	Bilateria
SLC1A3	cellular organisms
SURF1	Eukaryota
DCBLD2	Eukaryota
THRB	Bilateria
PIK3CA	Eukaryota
RAD21	Eukaryota
RPS6KA3	Eukaryota
CRHBP	Euarchontoglires
SFRP5	Bilateria
ASF1B	Eukaryota
HIST1H2AE	Eukaryota
TTK	cellular organisms
EN1	Bilateria
FHIT	cellular organisms
CDC25B	Eukaryota
PEA15	Euarchontoglires
CDKN1B	Euarchontoglires
RORA	Bilateria
NCF1	Eukaryota
TSLP	Euarchontoglires
RRAS2	Eukaryota
ANGPTL4	Bilateria
CA2	Eukaryota
NR1H4	Bilateria
MT1G	Homo
HCN4	Eukaryota
TRRAP	Eukaryota
IMPDH2	cellular organisms
CRY1	cellular organisms
GCG	Amniota
RNF144A	Eukaryota
ABCB8	cellular organisms
HIP1R	Eukaryota
AK4	cellular organisms
CNBP	Eukaryota
ACOX1	Eukaryota
CDH5	Bilateria
IL2	Boreoeutheria
ATG7	Eukaryota
CCL3	Amniota
SGPL1	cellular organisms
IL22	Euarchontoglires
CSF2	Boreoeutheria
PTPN1	Eukaryota
SIRT3	cellular organisms
SLC19A3	Eukaryota
TRIM21	Eukaryota
BTG1	Eukaryota
UPF3B	Eukaryota
PANK2	Eukaryota
PRRX1	Eukaryota
HOXA10	Eukaryota
ITGA2	Bilateria
PRDM2	Opisthokonta
IFITM5	Euarchontoglires
P2RY10	Bilateria
REL	Bilateria
STAT6	Eukaryota
GLRA1	cellular organisms
ERCC4	Eukaryota
SOX11	Opisthokonta
PAPSS2	cellular organisms
HOXA5	Bilateria
MAPK14	Eukaryota
SFTPB	Amniota
SLC22A9	cellular organisms
NFAT5	Amniota
PIAS4	Eukaryota
SYTL4	Eukaryota
MYOD1	Bilateria
CSTA	Eukaryota
AHR	Bilateria
S100A6	Amniota
LHX3	Eukaryota
FOXG1	Opisthokonta
SNF8	Eukaryota
TXN2	cellular organisms
PCK2	cellular organisms
AREG	Amniota
GTF2I	Boreoeutheria
AKT2	Eukaryota
CSNK2B	Eukaryota
CTBP2	cellular organisms
VCP	cellular organisms
GNLY	Homo
RRM2B	cellular organisms
XAF1	Boreoeutheria
ADIPOR2	Eukaryota
TGIF2	Eukaryota
APOBR	Euarchontoglires
ZNF652	Bilateria
HLA-DRA	Euteleostomi
CREBBP	Eukaryota
LYL1	Bilateria
CST5	Amniota
GUCA2B	Euarchontoglires
RFXAP	Euarchontoglires
EPHB2	Eukaryota
RNASE2	Boreoeutheria
COL1A1	Euteleostomi
SHC1	Bilateria
KLK2	Bilateria
LGALS3	Bilateria
ZNF143	Bilateria
PERP	Euteleostomi
EAPP	Euarchontoglires
ZNF423	Bilateria
SMAD3	Bilateria
DRAM1	Euteleostomi
NDC80	Eukaryota
OTX1	Eukaryota
CNOT8	Eukaryota
IRF9	Amniota
EZR	Eukaryota
LAMA1	Bilateria
SCAND1	Boreoeutheria
FDPS	cellular organisms
BIRC5	Opisthokonta
TBX3	Bilateria
BCL2L11	Euarchontoglires
EBI3	Amniota
ATG5	Eukaryota
MLLT3	Eukaryota
TM4SF1	Boreoeutheria
TGM4	Amniota
UGT1A6	cellular organisms
GCM2	Bilateria
XRCC5	Eukaryota
CHRNA3	Bilateria
NPC1L1	Opisthokonta
ULBP1	Boreoeutheria
TNFAIP6	Bilateria
RAB3A	Eukaryota
BCL2A1	Amniota
THY1	Amniota
TRPC1	Bilateria
SLC31A1	Eukaryota
AICDA	Theria
NFKB2	Eukaryota
PMEPA1	Euarchontoglires
STAT5A	Eukaryota
BTG3	Eukaryota
UGT1A7	cellular organisms
TCN2	Boreoeutheria
CEBPE	Bilateria
CAV1	Bilateria
BRCA1	Eukaryota
ADH1A	cellular organisms
SART3	Eukaryota
HAS2	Opisthokonta
SOST	Amniota
CTSD	Eukaryota
OPTN	Euteleostomi
MAP3K1	Eukaryota
IFITM3	Euarchontoglires
MUC2	Bilateria
NGFR	Amniota
SLC3A1	cellular organisms
HNRNPD	Eukaryota
NR4A3	Bilateria
BMP4	Bilateria
ACAN	Bilateria
CXCR3	Bilateria
DAB2	Bilateria
CD69	Euteleostomi
MYCBP	Eukaryota
DROSHA	cellular organisms
ARF1	Eukaryota
CEL	cellular organisms
CLDN3	Euteleostomi
ID4	Bilateria
UPP1	cellular organisms
REST	Bilateria
DEFB4A	Boreoeutheria
LAPTM4B	Amniota
IL13	Boreoeutheria
PDCD5	cellular organisms
HSPB1	Bilateria
HSPH1	cellular organisms
OXTR	Bilateria
STMN1	Amniota
TFAP4	Bilateria
PFKP	cellular organisms
KLF4	Eukaryota
RB1CC1	Euarchontoglires
DGKG	Eukaryota
MAP1LC3B	Eukaryota
SLC10A1	cellular organisms
ASPN	Eukaryota
SPDEF	Bilateria
S100A2	Amniota
WASF2	Eukaryota
KRT10	Bilateria
MICA	Amniota
NDRG1	cellular organisms
CSNK1A1	cellular organisms
LMX1B	Eukaryota
CTSK	Eukaryota
AMHR2	Eukaryota
ALPL	cellular organisms
PAX4	Eukaryota
ANAPC4	Eukaryota
IL1RL1	Bilateria
SMUG1	Boreoeutheria
FOSL2	Amniota
PENK	Boreoeutheria
PHLDA1	Euteleostomi
CCNC	Eukaryota
HOXB8	Eukaryota
FOXH1	Opisthokonta
CD68	Euarchontoglires
SMAD7	Bilateria
HCN2	cellular organisms
HMMR	Euarchontoglires
KAT5	Eukaryota
CTLA4	Amniota
SERPINB5	cellular organisms
CRISP3	Eukaryota
DACT2	Euteleostomi
HOXC8	Eukaryota
HMG20B	Eukaryota
ABCB4	cellular organisms
NDUFV1	cellular organisms
CCL17	Amniota
PRDX5	cellular organisms
IRF1	Amniota
TBX2	Bilateria
AXL	Eukaryota
SALL2	Opisthokonta
EGR3	Opisthokonta
CREB1	Bilateria
TWIST2	Bilateria
PARG	Eukaryota
POSTN	Eukaryota
F9	Bilateria
SLC3A2	cellular organisms
COL1A2	Euteleostomi
CDH11	Bilateria
S100A4	Amniota
EWSR1	Eukaryota
GYPB	Homininae
GATA3	Eukaryota
LRBA	Eukaryota
HSF4	Eukaryota
BACE2	Eukaryota
GATA1	Eukaryota
ETNK2	Eukaryota
NR3C1	Bilateria
TUBA1B	Eukaryota
ATXN2	Eukaryota
JAG1	Eukaryota
GH1	Euteleostomi
PRKCA	Eukaryota
TPMT	cellular organisms
ITGB7	Bilateria
CDKN2B	Eukaryota
TYR	Bilateria
POU4F1	Bilateria
IL12RB2	Euteleostomi
ASS1	cellular organisms
MPG	cellular organisms
RBPJ	Opisthokonta
POLH	cellular organisms
PKNOX1	Eukaryota
ESR1	Bilateria
PRAME	Euteleostomi
HEY1	Bilateria
IHH	Bilateria
ERVFRD-1	Euarchontoglires
NFATC1	Boreoeutheria
NPM1	Amniota
PRDM1	Bilateria
OXT	Amniota
EXT1	Eukaryota
MAFF	Euteleostomi
WNT3A	Bilateria
IFI16	Euarchontoglires
INSR	Eukaryota
VMP1	Eukaryota
MAFG	Euteleostomi
MSX2	Bilateria
DUX4	Eukaryota
BDKRB1	Bilateria
SCARF1	Eukaryota
MAP2K4	cellular organisms
HLA-C	Amniota
HSPA8	cellular organisms
YBX1	cellular organisms
OTX2	Eukaryota
PNRC2	Euteleostomi
CDO1	cellular organisms
SIRT6	cellular organisms
SCARB1	Eukaryota
MACROD1	cellular organisms
CORO1C	Eukaryota
CHEK1	Eukaryota
CDC42BPG	Eukaryota
HLA-DRB5	Euteleostomi
HMGB2	Eukaryota
POU5F1	Bilateria
RRP1B	Eukaryota
CDK11B	cellular organisms
DHX9	cellular organisms
KRT15	Bilateria
SIN3A	Eukaryota
IL24	Euarchontoglires
BMP2	Bilateria
DACT3	Euteleostomi
TGFBR1	Eukaryota
CD86	Boreoeutheria
KAT6A	Eukaryota
FOXP2	Opisthokonta
RBBP7	Eukaryota
DDB1	Eukaryota
CHRNA1	Bilateria
RBBP8	Eukaryota
SOX10	Eukaryota
TBX18	Bilateria
ZIC2	Opisthokonta
SLC7A5	cellular organisms
CENPH	Amniota
FMR1	Bilateria
FOXI1	Opisthokonta
APOM	Euarchontoglires
CYP1A2	cellular organisms
RPRM	Euteleostomi
KIF2C	Eukaryota
TSHB	Amniota
ELANE	Bilateria
KLF3	Opisthokonta
IFNGR1	Boreoeutheria
ID2	Bilateria
TNFRSF11B	Amniota
SOD2	cellular organisms
ASPH	Euteleostomi
POU2F2	Bilateria
SOX4	Eukaryota
MAP4	Boreoeutheria
SLC39A8	Eukaryota
CYP8B1	cellular organisms
UCN	Euarchontoglires
CYP11B1	cellular organisms
SLC8A3	cellular organisms
SKI	Euteleostomi
PLAGL2	Euteleostomi
SH3BP2	Euarchontoglires
UBA7	cellular organisms
DEK	Eukaryota
LCOR	Amniota
KLF15	Opisthokonta
STK39	cellular organisms
LMO1	Opisthokonta
ENPP2	Opisthokonta
APOA5	Euteleostomi
EPOR	Boreoeutheria
STAT2	Eukaryota
HMGB1	Eukaryota
AKR1C3	cellular organisms
SERPINA3	cellular organisms
FOXL1	Opisthokonta
THBS1	Bilateria
SOCS2	Eukaryota
PVR	Bilateria
FAF1	Eukaryota
TIAL1	Eukaryota
AGO1	Eukaryota
SLC5A5	cellular organisms
ACE	Bilateria
PTPRG	Eukaryota
ADGRB1	Bilateria
CYP27A1	cellular organisms
CDH2	Bilateria
KDM4C	Eukaryota
CUX1	Eukaryota
HOXA2	Bilateria
WNT2B	Bilateria
ANPEP	cellular organisms
HSPA1A	cellular organisms
CD33	Euarchontoglires
PAEP	Boreoeutheria
RLN1	Boreoeutheria
B4GALT1	Bilateria
PLAT	Bilateria
RGN	cellular organisms
INSL3	Boreoeutheria
HBA1	Euteleostomi
SIX3	Eukaryota
TLR3	Eukaryota
TK1	cellular organisms
PLAC1	Boreoeutheria
PITX3	Eukaryota
MACC1	Euteleostomi
CASP2	Bilateria
TCFL5	Homo
KLF9	Opisthokonta
DDIT4	Bilateria
EPHA2	Eukaryota
KLF2	Opisthokonta
SALL4	Opisthokonta
CD99	Homo
CAPN10	Eukaryota
NCBP1	Eukaryota
FRMD5	Eukaryota
ERN1	cellular organisms
KIN	Eukaryota
MUC5B	Amniota
MAPK7	Eukaryota
H2AFX	Eukaryota
SPARC	Bilateria
ARG2	cellular organisms
TLR2	Bilateria
ALKBH2	Eukaryota
CD2AP	Eukaryota
CD2	Boreoeutheria
PKP3	Eukaryota
DAXX	Bilateria
PPP2R2B	Eukaryota
SSB	Eukaryota
SMAD4	Bilateria
KRT14	Bilateria
KCNJ11	Bilateria
CPT1B	Opisthokonta
F8	Bilateria
IRS2	Bilateria
CDK4	Eukaryota
TMPO	Boreoeutheria
ZFP42	Eukaryota
CCL19	Amniota
NFATC2	Boreoeutheria
PAX3	Eukaryota
CASR	Eukaryota
HLA-G	Amniota
NPPB	Euteleostomi
FCER1A	Bilateria
PROC	Bilateria
HLA-F	Eukaryota
S100A10	Amniota
MMP11	Eukaryota
KISS1R	Bilateria
SNAPC1	Euarchontoglires
HOXD9	Eukaryota
PGF	Euteleostomi
GDF5	Bilateria
CIAO1	Eukaryota
CYP27B1	cellular organisms
SLC22A8	cellular organisms
LHX2	Eukaryota
ZNF444	Amniota
PTF1A	Bilateria
THRA	Bilateria
FOXF2	Opisthokonta
FURIN	cellular organisms
TBPL1	cellular organisms
ING5	Eukaryota
SLC29A1	Eukaryota
FGF4	Bilateria
DR1	Eukaryota
ALAS2	cellular organisms
MYH6	Eukaryota
CSH1	Euteleostomi
WTAP	Eukaryota
TG	cellular organisms
CPEB1	Bilateria
NMU	Amniota
ABCG1	cellular organisms
COL4A3	Bilateria
CRABP1	Bilateria
DNAAF4	Eukaryota
F2R	Bilateria
SMAD2	Bilateria
CYP3A5	cellular organisms
PSMB5	cellular organisms
FOXP3	Opisthokonta
NSFL1C	Eukaryota
PEG3	Amniota
RSPO2	Euteleostomi
GSPT1	cellular organisms
SCNN1B	Bilateria
DLX3	Bilateria
TGFBR2	Eukaryota
SNAP25	cellular organisms
CLEC4C	Bilateria
HNRNPR	Eukaryota
ASH1L	Eukaryota
UBB	Eukaryota
ONECUT2	Bilateria
HNRNPA1	Eukaryota
CEBPG	Bilateria
ADORA1	Bilateria
DHCR24	cellular organisms
ABCC3	cellular organisms
SLC6A6	cellular organisms
IGF2R	Opisthokonta
FOXC2	Opisthokonta
ATRX	cellular organisms
HBA2	Euteleostomi
DISC1	Euarchontoglires
SLCO1B3	Bilateria
NUPR1	Euarchontoglires
IL12B	Amniota
NPAT	Euarchontoglires
ACTA2	Eukaryota
P4HA1	Eukaryota
CDH6	Bilateria
FADD	Boreoeutheria
GAST	Boreoeutheria
CDX2	Bilateria
GAS2	Bilateria
FST	Euteleostomi
KLF7	Opisthokonta
SPINK4	Amniota
AIRE	Eukaryota
COL2A1	Bilateria
ALDOB	Eukaryota
CEP55	Euteleostomi
TNF	Boreoeutheria
SRR	cellular organisms
CDC20	Eukaryota
RNF111	Eukaryota
MSH2	cellular organisms
ITGB3BP	Amniota
IL2RA	Boreoeutheria
UBP1	Bilateria
ADRB3	Bilateria
NEUROG3	Bilateria
BAALC	Euarchontoglires
PPIG	cellular organisms
LAMTOR5	Eukaryota
HSF1	Eukaryota
OLFM4	Euteleostomi
PON2	Bilateria
MITF	Eukaryota
ABCC4	cellular organisms
TAC3	Boreoeutheria
CA12	Eukaryota
CDKN2C	cellular organisms
KRT19	Bilateria
BPTF	Eukaryota
GRM2	Eukaryota
TNFSF10	Amniota
BARX2	Bilateria
ZIC3	Opisthokonta
FBLN1	Eukaryota
DBH	Bilateria
ITGAL	Bilateria
TOP1MT	Eukaryota
B4GALT5	Bilateria
ACSL1	cellular organisms
TFAP2A	Bilateria
PSG7	Bilateria
KCNQ3	cellular organisms
HNF4G	Bilateria
ALOX5AP	Boreoeutheria
ETV7	Bilateria
WNT4	Bilateria
EGR1	Opisthokonta
LSP1	Euarchontoglires
PCGF2	Eukaryota
ACRV1	Eukaryota
HLA-DMA	Euteleostomi
KIR3DL1	Boreoeutheria
VHL	Euarchontoglires
CARTPT	Boreoeutheria
CEACAM1	Bilateria
PTBP1	Eukaryota
TFF1	Boreoeutheria
NTF3	Euteleostomi
SNAI2	Bilateria
GSTA1	Eukaryota
COL7A1	Bilateria
HPR	Bilateria
TOP3A	cellular organisms
ICAM3	Boreoeutheria
TBC1D22A	Eukaryota
DEAF1	Bilateria
ANGPT2	Bilateria
CRX	Eukaryota
CHI3L1	cellular organisms
MLH1	cellular organisms
ADARB2	Eukaryota
NOLC1	Opisthokonta
LHX6	Eukaryota
NRL	Euteleostomi
TNNI3	Bilateria
HMGCS1	cellular organisms
CXCR1	Bilateria
SERPINF1	cellular organisms
EGLN1	Eukaryota
ZIC1	Opisthokonta
TNFRSF10A	Boreoeutheria
PAWR	Euarchontoglires
PTN	Tetrapoda
RGS10	Eukaryota
IDO1	Opisthokonta
ST3GAL4	Eukaryota
CEBPA	Bilateria
SEC14L2	Eukaryota
HRK	Euarchontoglires
NFYA	Eukaryota
SETD2	Eukaryota
TAF1A	Euarchontoglires
ATP2A2	cellular organisms
CLEC4G	Euteleostomi
DNM3	Eukaryota
SP3	Opisthokonta
CCK	Amniota
LSS	Bilateria
SLIT2	Eukaryota
LAMA3	Bilateria
GCK	Eukaryota
ARX	cellular organisms
DMC1	cellular organisms
BRPF1	Eukaryota
PAK1	Eukaryota
MAFA	Amniota
DOK1	Amniota
FHL5	Eukaryota
ELK1	Bilateria
BRIP1	Eukaryota
SCT	Eukaryota
HGF	Amniota
DSC2	Bilateria
SMO	Eukaryota
MLX	Opisthokonta
FOLR1	Amniota
CAD	cellular organisms
NRF1	Bilateria
DBI	Opisthokonta
SCG3	Boreoeutheria
CD3G	Amniota
WBP1	Eukaryota
SPEN	Eukaryota
KLF14	Opisthokonta
TCF3	Bilateria
ELN	Homo
CPD	Eukaryota
CGB5	Amniota
CNR1	Bilateria
MMP20	Eukaryota
RP1	Eukaryota
KLK3	Bilateria
ALPI	cellular organisms
NOS3	cellular organisms
FAAH	Eukaryota
FAP	cellular organisms
POR	cellular organisms
DUSP1	Eukaryota
ODC1	Eukaryota
COP1	Eukaryota
MSL1	Eukaryota
ACAT2	Eukaryota
HLF	Bilateria
JUNB	cellular organisms
CEBPZ	Boreoeutheria
MME	Bilateria
PLD1	Eukaryota
HK3	Bilateria
F3	Boreoeutheria
OSM	Euteleostomi
PMP22	Euteleostomi
SAA2	Boreoeutheria
PDX1	cellular organisms
GYPA	Homininae
BTF3	Eukaryota
LHB	Amniota
SP1	Opisthokonta
ALB	Amniota
RAC1	Eukaryota
MBD1	Opisthokonta
ING2	Eukaryota
CYP2D6	cellular organisms
SI	Amniota
DBP	Amniota
CREB3	Eukaryota
CD14	Boreoeutheria
TPH2	cellular organisms
RS1	Eukaryota
SPP1	Boreoeutheria
MIP	cellular organisms
NFIC	Homo
TNC	Eukaryota
TTF2	cellular organisms
F10	Euteleostomi
MET	Eukaryota
SAT1	Eukaryota
HLA-DQB1	Eukaryota
PPOX	Boreoeutheria
SAA1	Boreoeutheria
TAT	Eukaryota
TXN	cellular organisms
APC	Bilateria
ARNT	Opisthokonta
ROR1	Bilateria
FGF2	Eukaryota
TRAF2	Boreoeutheria
FAS	cellular organisms
FHL1	Bilateria
NOS1	cellular organisms
ELK3	Bilateria
BEX2	Boreoeutheria
SPN	Bilateria
NRP1	Eukaryota
KRAS	Eukaryota
POLK	cellular organisms
PTPRO	Eukaryota
NOS2	Bilateria
DAP3	Bilateria
PIP	cellular organisms
USP21	Eukaryota
RHO	Bilateria
PIM1	Eukaryota
NBN	Eukaryota
HTT	Eukaryota
TAP1	cellular organisms
SOCS7	Eukaryota
CBS	cellular organisms
SMAD1	Bilateria
GK	Eukaryota
STAR	Bilateria
MAL	Euteleostomi
GRIP1	Bilateria
FLI1	Bilateria
CAT	Opisthokonta
LMO4	Eukaryota
GDA	Eukaryota
AVP	Eukaryota
NAT1	cellular organisms
PTH	cellular organisms
ATF2	Eukaryota
HK2	Eukaryota
PRG2	Eukaryota
ARG1	cellular organisms
TYMP	cellular organisms
LPL	Eukaryota
CDH1	Bilateria
LRP1	Bilateria
DLG4	cellular organisms
ADRA1A	Bilateria
GRIN1	cellular organisms
VDR	Bilateria
TCF4	Opisthokonta
HAP1	cellular organisms
RBP3	Eukaryota
AGT	Bilateria
PRM1	Eukaryota
CNP	Euteleostomi
CRP	Boreoeutheria
MTF1	Bilateria
ME1	cellular organisms
MED1	Bilateria
CHAT	Opisthokonta
GSS	Amniota
PIK3CD	Bilateria
GLS	cellular organisms
MAP2	Boreoeutheria
MCM2	cellular organisms
SF3B1	Opisthokonta
SF1	Eukaryota
MSC	Bilateria
PRF1	Eukaryota
BDP1	Opisthokonta
IFNA13	Amniota
HLA-DPB1	Euteleostomi
REN	Eukaryota
PIN1	Bilateria
TF	Boreoeutheria
CAMP	Amniota
LBP	Eukaryota
BST1	Euarchontoglires
GABPB2	cellular organisms
PTPA	Eukaryota
TPO	Euarchontoglires
CCR4	Bilateria
PC	Bilateria
CGA	Boreoeutheria
MIF	Amniota
ATF1	Euteleostomi
BACH1	Bilateria
ACAT1	Eukaryota
IL17A	Boreoeutheria
HRH1	Bilateria
SELP	Euteleostomi
HDC	cellular organisms
MID1	Eukaryota
CSNK2A1	Eukaryota
CDH3	Bilateria
HES1	Bilateria
PRG3	cellular organisms
NCL	cellular organisms
LDB1	Bilateria
MAP1A	Bilateria
MST1	Bilateria
UBC	cellular organisms
TAP2	Eukaryota
CSN2	Boreoeutheria
POLB	cellular organisms
CYC1	Eukaryota
EBF3	Bilateria
HNF4A	Bilateria
HDAC7	cellular organisms
MBP	Euteleostomi
HP	Bilateria
EPO	Bilateria
DDX21	cellular organisms
ERF	cellular organisms
AFP	Eukaryota
PSG1	Bilateria
FLG	Euarchontoglires
UGT1A1	cellular organisms
AHRR	cellular organisms
EIF2AK1	cellular organisms
NLK	cellular organisms
AR	Bilateria
ALDOA	Eukaryota
KIR2DL3	Boreoeutheria
ANXA8	Eukaryota
ECD	Boreoeutheria
HYAL1	Boreoeutheria
EAF2	Bilateria
SFN	Eukaryota
RPA2	cellular organisms
IL27	Euarchontoglires
AIP	Eukaryota
MBD2	Opisthokonta
VIP	cellular organisms
PDK1	cellular organisms
EAF1	cellular organisms
G6PD	cellular organisms
ELF1	Eukaryota
